F 22, 55, 89
NO         ./src/textures/img_no.png
SO ./src/textures/img_so.png
WE ./src/textures/img_we.png



EA ./src/textures/img_ea.png

C 254, 0, 255

        111111111111111111111111111111111111111111111111111111111 1111111111111111111111  111
        100000000000000000001000000000000000000000000000000000001 1000000000000000000001  101
        1000E00000000000000000000000000000011111111111111111111111 111000000000000000001  111
        11111111111111111111111111111111111111111111111111111111111111111111111111111111
             
1111111111111111111111111111111111111
1000000000000000000000000000000000111
1111111111111111111111111111111111111


                                        1111111111111111111111111111111111111111111
                                        1100111000000000000000000000000000000000001
                                        1111111111111111111111111111111111111111111