NO ./src/textures/img_no.png
SO ./src/textures/img_so.png
WE ./src/textures/img_we.png
EA ./src/textures/img_ea.png



F 0,100,40
C 255, 0, 0

11111111111111111111111111111111111111111111111111111111111111111111111111111111
10000000000000000000000000000000000000000000000000000000000000000000000000000001
10N00000000000000000000000000000000000000000000000000000000000000000000000000001
10000000000000000000000000000000000000000000000000000000000000000000000000000001
11111111111111111111111111111111111111111111111111111111111111111111111111111111