F 22, 55, 89
NO         ./src/textures/img_no.png
SO ./src/textures/img_so.png
WE ./src/textures/img_we.png
EA ./src/textures/img_ea.png
C 254, 0, 255

1111111111111111111111     111111111111111
1000000000000000000001     100000000000001
1000N00000000000000001     100000000000001
1111111111111111111111     111111111111111

111111111111111111111111111111111
100000000000000000000000000000001
100000000000000000000000000000001
111111111111111111111111111111111
