NO ./src/textures/img_no.png
SO ./src/textures/img_so.png
WE ./src/textures/img_we.png
WE ./src/textures/img_we.png
EA ./src/textures/img_ea.png



F 0,100,40
C 125, 231, 255


        1111111111111111111111111
        1000000000110000000000001
        10110000011100000N0000001
        1001000000000000000000001
111111111011000001110000000000001
100000000011000001110111111011111
11110111111111011100000010001
11110111111111011101010000001
11000000110101011100000010001
10000000000000001100000010001
10000000000000001101010010001
11000001110101011111011110001
11110111 1000001 101111010001
11111111 1111111 111111111111